lblTituloPantalla=Consultar Datos SAT
lblIndividual=Individual
lblRFC=RFC
lblCFDI=CFDI
lblEnviar=Enviar
lblMasivo=Masivo
lblPath=Path
lblSeleccionaArchivo=Selecciona Archivo
lblCargando=Cargando
lblPersonasFisicas=Personas Físicas
lblPersonasMorales=Personas Morales
lblUsoCFDI=Uso CFDI
lblRegimenFiscal=Regimen Fiscal
lblConfirmar=Confirmar
lblConfirmacion=Confirmación
lblSeleccionar=-- Seleccionar --
lblDescargarTemplate=Descargar Template
lblIdCIF=IdCIF
lblCliente=Cliente
lblValidar=Validar
lblDescargarLogErrores=Descargar Log Errores
gvRFC=RFC
gvIDCFDI=ID CFDI
gvCURP=CURP
gvNombre=Nombre
gvApellidoPaterno=Apellido Paterno
gvApellidoMaterno=Apellido Materno
gvFechaNacimiento=Fecha Nacimiento
gvFechaInicioOperaciones=Fecha Inicio Operaciones
gvSituacionContribuyente=Situación Contribuyente
gvFechaUltimoCambioSituacion=Fecha Ultimo Cambio Situación
gvEntidadFederativa=Entidad Federativa
gvMunicipio=Municipio
gvColonia=Colonia
gvTipoVialidad=Tipo Vialidad
gvNombreVialidad=Nombre Vialidad
gvNumeroExterior=Numero Exterior
gvNumeroInterior=Numero Interior
gvCP=CP
gvCorreo=Correo
gvAL=AL
gvRegimen=Régimen
gvFechaAlta=Fecha Alta
gvError=Error
gvErrorMensaje=Error Mensaje
gvRazonSocial=Razón Social
gvRegimenCapital=Regimen Capital
gvFechaConstitucion=Fecha Constitución
msgTamanioInvalido=El tamaño del archivo excede el máximo (5MB)
lblResultadosSAT=Resultados SAT
msgSeleccionarRegimenUsoCfdi=Favor de seleccionar el régimen y Uso CFDI
msgGuardadoExitoso=La información se guardó exitósamente
msgResultado=<b>Total Registros Procesados:</b> #TOTAL#, <b>Total Registros Exitosos:</b> #EXITOSOS#, <b>Total Errores:</b> #ERRORES#
msgCamposObligatorios=Favor de introducir RFC, CFDI y Uso CFDI
msgActualizarInformacion=La información ya ha sido confirmada, ¿Desea confirmar de nuevo?
msgSeleccionarUsoCFDI=Favor de seleccionar Uso CFDI
msgSeleccionarCliente=Favor de introducir el cliente
msgNoExisteCliente=El Cliente capturado en el parámetro de la herramienta no contiene un RFC válido para el SAT
lblCerrarSesion=Cerrar Sesión
msgSeleccionarRegimen=Favor de seleccionar el régimen
